#مرحله حذفی#

#یک‌چهارم پایانی#
#Portugal#5#3#North Korea#
#West Germany#4#0#Uruguay#
#Soviet Union#2#1#Hungary#
#England#1#0#Argentina#


#نیمه‌پایانی#
#West Germany#2#1#Soviet Union#
#England#2#1#Portugal#

#رده‌بندی#
#Portugal#2#1#Soviet Union#

#پایانی#
#30 جولای 1966 - لندن#
#England#4#2#West Germany#
#انگلستان : گوردون بنکس، پيتر بونتى، رون اسپرينگت ،جيمى آرمفيلد، جرالد بايرن، جک چارلتون، جورج کوهن، بابى مور (کاپيتان)، رى ويلسون. آلن بال، ايان کالاگان، بابى چارلتون، جورج ايستام، رون فلاورز، نورمن هانتر، مارتين پيترز، نابى استايلز. جان کونلى، جيمى گريوز، راجر هانت، جف هورست، ترى پاين. سرمربى: الف رمزی#
#آلمان غربی : تیلکوفسکی - هوتگز - وبر - شولتز - شنلینگر - بکن باوئر - هالر - اوورات - زیلر - هلد - امریخ -
مربی: هلموت شون#
#گل ها : هورست (18 ، 98 ، 120)، پیترز (78) برای انگلستان ؛ هالر (12)، وبر (90) برای آلمان‌غربی #
#تماشاگر : 97000 نفر #
#داور : دیینس (سوییس)#