#مرحله حذفی#

#یک‌هشتم پایانی – یک‌حذفی#
#Uruguay#2#1#South Korea#
#United States#1#2#Ghana#
#Germany#4#1#England#
#Argentina#3#1#Mexico#
#Netherlands#2#1#Slovakia#
#Brazil#3#0#Chile#
#Paraguay#0(5)#(3)0#Japan#
#Spain#1#0#Portugal#

#یک‌چهارم پایانی#
#Netherlands#2#1#Brazil#
#Uruguay#1(4)#(2)1#Ghana#
#Argentina#0#4#Germany#
#Paraguay#0#1#Spain#

#نیمه‌پایانی#
#Uruguay#2#3#Netherlands#
#Germany#0#1#Spain#

#رده‌بندی#
#Uruguay#2#3#Germany#

#پایانی#
#۱۱ ژوئیه ۲۰۱۰ - ژوهانسبورگ #
#Netherlands#0#1#Spain#
#گل ها : آندرس اینیستا (116) #
#اخراج: هیتینگا(هلند) #
#بازیکنان اسپانيا: ايكر كاسياس، سرخيو راموس،‌ جرارد پيكه، كارلس پويول،‌ خوان كاپدويا،‌ سرخيو بوسكتس، ژابي آلونسو، سسك فابرگاس، آندرس اينيستا، ژاوي ارناندز، پدرو رودريگز، خسوس ناواس ، داويد ويا ، فرناندو تورس ، سرمربي: ويسنته دل بوسكه #
#بازیکنان هلند: مارتين استكلنبرگ، گئورگي فان در ويل، جاني هيتينگا، يوريس ماتيسن، جيوواني فان برونكهورست، ادسون برانفايد، مارك فان بومل، نايجل دي يانگ ،رافائل فان درفارت،‌ رابين فان پرسي، درك كوئيت ، اليرو اليا ، آرين روبن ، وسلي اسنايدر، سرمربي: برت فان مارويك#
#داور: هاوارد وب (انگلستان)#
#تماشاگر: ۸۴٬۴۹۰ نفر#
