#مرحله حذفی#

#یک‌چهارم پایانی#
#Soviet Union#0#1#Uruguay#
#Italy#4#1#Mexico#
#Brazil#4#2#Peru#
#West Germany#3#2#England#

#نیمه‌پایانی#
#Uruguay#1#3#Brazil#
#Italy#4#3#West Germany#

#رده‌بندی#
#Uruguay#0#1#West Germany#

#پایانی#
#21ژوئن1970 - مکزیکوسیتی#
#Brazil#4#1#Italy#
#گلها : پله(18) - جرسون(66) - جرزینیو(71) - کارلوس آلبرتو(86) - برای برزیل گل زنی کردند . -
تک گل ایتالیا : بونین سنیا (37)#
#بازیکنان برزیل : فیلیکس - کارلوس آلبرتو - بریتو - توستائو - پیاتزا - اورالدو - کلودوالدو - جرسون - جرزینیو - پله - روهلینو #
#بازیکنان ایتالیا : آلبرتوسی - چرا - بورگنیش - روزاتو - برتینی(جولیانو) - فاکتی - دومنینی - ماتزولا - ده سیستی - بونین سنیا(ریورا) - ریوا - #
#داور :رودولف گلوکنر(آلمان شرقی)#
#تماشاگر: 107412 نفر#
