#مرحله حذفی#

#نیمه‌پایانی#
#Poland#0#2#Italy#
#West Germany#3#3#France#

#رده‌بندی#
#Poland#3#2#France#

#پایانی#
#مادرید -11 جولای 1982#
#Italy#3#1#West Germany#
#بازیکنان ایتالیا: زوف٬ کابرینی٬ شیره آ ٬ جنتیله٬ گولوواتی٬ اوریالی٬ برگومی٬ تاردلی٬ کونتی٬ گراتزیانی(آلتوبلی)٬ روسی- مربی: انزو بیر تزوت#
#بازیکنان آلمان غربی : شوماخر٬ کالتس٬ اشتلیکه٬ فورستر٬ برند فوستر٬ درملر(هروبش)٬ برایتنر٬ بریگل٬ لیتبارسکی٬ فیشر٬ رومنیگه(هانسی مولر)- مربی:یوپ دروال#
#گل ها:گلزنان تیم ملی ایتالیا:روسی(56)٬ تاردلی(69) ٬ آلتوبلی(80) ٬ گلزن تیم ملی آلمان غربی: برایتنر(83-ضربه پنالتی) #
# داور : آرنالدو کوئیلیو ازبرزیل#
#تماشاگر: 90000 نفر#
