#مرحله حذفی#

#یک‌هشتم پایانی – یک‌حذفی#
#Italy#1#0#Norway#
#Brazil#4#1#Chile#
#France#1#0#Paraguay#
#Nigeria#1#4#Denmark#
#Germany#2#1#Mexico#
#Netherlands#2#1#Yugoslavia#
#Romania#0#1#Croatia#
#Argentina#2(4)#(3)2#England#

#یک‌چهارم پایانی#
#Italy#0(3)#(4)0#France#
#Brazil#3#2#Denmark#
#Netherlands#2#1#Argentina#
#Germany#0#3#Croatia#

#نیمه‌پایانی#
#Brazil#1(4)#(2)1#Netherlands#
#France#2#1#Croatia#

#رده‌بندی#
#Netherlands#1#2#Croatia#

#پایانی#
# ۱۲ جولای ۱۹۹۸ - سنت دنیز#
#Brazil#0#3#France#
#گل ها: زیدان(۲۷ ٬ ۴۵ )٬ پتی(۹۰ )#
#اخراج: دسایی لز فرانسه#
#بازیکنان فرانسه: بارتز ٬ دسایی٬ لیزلرازو٬ لیوف ٬ تورام ٬٬ ژورکائف(ویرا)٬ دشام ٬ زیدان٬ پوتی٬ کارمبئو(بوقوسیان) گیوارش(دوگاری)٬ مربی : امه ژاکه#
#بازیکنان برزیل: تافارل٬ کافو ٬ آلدایر ٬ بایانو٬ کارلوس٬ سامپایو(ادموندو)٬ دونگا٬ ریوالدو٬ لئوناردو(دنیلسون)٬ به به تو٬ رونالدو ، مربی: ماریو زاگالو#
#داور : سعید بلگولا(مراکش)#
#تماشاگر: ۸۰۰۰۰ نفر#