#مرحله حذفی#

#رده‌بندی#
#Brazil#2#1#Italy#

#پایانی#
#  25 ژوئن 1978 - بوینوس‌آیرس #
#Netherlands#1#3#Argentina#
#گل ها : کمپس(105،38)، برتونی (115)، برای آرژانتین ؛ نانینگا(80) برای هلند#
#بازیکنان آرژانتین : فیلول، اولگاین، گالوان، تارانتینی، آردیلس (لاروسا)، گالگو، کمپس، برتونی، لوکو، اوریتز (هوسمان)#
#بازیکنان هلند : یونگ بلود، یانسن (سوربیر)، براندتس، کرول، پورتویلت، هان، دبیلو. وان درکرکهوف، نیسکنز، ار.وان‌درکرکهوف، رپ (نانینگا)، رنسن برینگ#
#داور : سرجیوگونلا (ایتالیا)#
#تماشاگران: 71,483 نفر#
