#مرحله حذفی#

#یک‌هشتم پایانی – یک‌حذفی#
#Germany#2#0#Sweden#
#Argentina#2#1#Mexico#
#England#1#0#Ecuador#
#Portugal#1#0#Netherlands#
#Italy#1#0#Australia#
#Switzerland#0(0)#(3)0#Ukraine#
#Brazil#3#0#Ghana#
#Spain#1#3#France#

#یک‌چهارم پایانی#
#Germany#1(4)#(2)1#Argentina#
#Italy#3#0#Ukraine#
#England#0(1)#(3)0#Portugal#
#Brazil#0#1#France#

#نیمه‌پایانی#
#Germany#0#2#Italy#
#Portugal#0#1#France#

#رده‌بندی#
#Germany#3#1#Portugal#

#پایانی#
#  ۹ ژوئیه ۲۰۰۶ - برلین #
#Italy#1(5)#(3)1#France#
#گل ها : زیدان برای فرانسه(7) و ماتراتزی برای ایتالی(19) #
#اخراج: زیدان(۱۱۳) از فرانسه#
#بازیکنان ایتالیا: بوفون٬ زامبروتا٬ کاناوارو٬ ماتراتزی٬ گروسو٬ کامورانزی(دل پیرو)٬ گتوزو٬ پیرلو٬ پروتا( یاکوئینتا)٬ توتی٬(دروسی) ٬ لوکاتونی٬ مربی ٬ مارچلو لیپی#
#بازیکنان فرانسه: بارتز٬ سانیول٬ تورام٬ گالاس٬ آبیدال٬ ویرا(دیارا) ریبری(ترزگه) ٬ ماکلله٬ زیدان٬ مالودا٬ آنری(ویلتورد) ، مربی: ریموند دومنک#
#داور: هوراسیو الیزوندو(آرژانتین)#
#تماشاگر: ۶۹۰۰۰ نفر#