#پایانی#

#Uruguay#2#2#Spain#
#Brazil#7#1#Sweden#
#Brazil#6#1#Spain#
#Uruguay#3#2#Sweden#
#Sweden#3#1#Spain#
#Uruguay#2#1#Brazil#
#بازیکنان اروگوئه: ماسپولی؛ م گونزالس، ترخا؛ گامبتا، وارلا (کاپیتان)، آندراده؛ گیخیا، پرز، میگوئز، شیافینو، موران#
#بازیکنان برزیل: باربوسا؛ آگوستو (کاپیتان)، ژوونال؛ بائوئر، دانیلو، بیگوده؛ فرایچا، زیزینیو، آدمیر، ژایر، شیکو#
#گل: شیافینو، گیخیا (اروگوئه) – فرایچا (برزیل)#
#داور: ریدر (انگلستان)#
#تماشاگر: ۲۰۵۰۰۰ نفر#