#مرحله حذفی#

#یک‌هشتم پایانی – یک‌حذفی#
#Mexico#2#0#Bulgaria#
#Soviet Union#3#4#Belgium#
#Brazil#4#0#Poland#
#Argentina#1#0#Uruguay#
#Italy#0#2#France#
#Morocco#0#1#West Germany#
#England#3#0#Paraguay#
#Denmark#1#5#Spain#

#یک‌چهارم پایانی#
#Brazil#1(3)#(4)1#France#
#West Germany#0(4)#(1)0#Mexico#
#Argentina#2#1#England#
#Spain#1(4)#(5)1#Belgium#


#نیمه‌پایانی#
#France#0#2#West Germany#
#Argentina#2#0#Belgium#

#رده‌بندی#
#France#4#2#Belgium#

#پایانی#
#۲۹ ژوئن ۱۹۸۶ - مکزیکوسیتی#
#Argentina#3#2#West Germany#
#بازیکنان آرژانتین : لوییس ایسلاس، نری پومپیدو، هکتور میگوئل زلادا ،خوزه لوییس براون، نستور کلاسن، خوزه لوییس کوکیوفو، اوسکار گاره، ریکاردو گیوستی، خولیو یورگ اولارتیکوئچا، دانیل پاسارلا، اوسکار روگیه ری ،سرجیو آلمیرون، سرجیو دانیل باتیستا، ریکاردو بوچینی، یورگ بوروچاگا، هکتور آدولف هنریک، دیه گو مارادونا ،کلادیو بروگی، پدرو پابلو پاسکولی، کارلوس تاپیا، مارچلو تروبیانی، یورگ والدانو - سرمربی کارلوس بیلاردو#
#بازیکنان آلمان غربی: شوماخر٬ بره مه٬ کارل هاینس٬ فورستر٬ برتولد٬ یاکوبس٬ بریگل٬ نوربرت ادر٬ ماته ئوس٬ ماگات(هوینس)٬ آلوفس(فولر)٬ رومنیگه - مربی : فرانتس بکن بائر#
#داور:رومالدوفیلیو(برزیل)#
#تماشاگر: 114,600 نفر#