#مرحله حذفی#

#رده‌بندی#
#Brazil#0#1#Poland#

#پایانی#
# ۷ جولای ۱۹۷۴ - مونیخ #
#Netherlands#1#2#West Germany#
#گل ها:گلزنان تیم ملی آلمان غربی :پل برایتنر(25)٬ گرد مولر(43) گلزن تیم ملی هلند٬ نیکنز(1)#
#ترکیب تیم ملی آلمان غربی: مه یر ٬ فوگتس٬ شوارتزنبک٬ بکن بائر٬ برایتنر٬ بونهوف٬ هوینس٬ اوورات٬ گرابوفسکی٬ هولزنباین٬ مولر - مربی: هلوت شون#
#ترکیب تیم ملی هلند: بلود٬ سوربیه٬ رنسن برینگ(دی یانگ) ٬ هان ٬ کرول ٬ یانسن٬ فان هانگم٬ نیکنز٬ رپ ٬ رنسن برینک(فان در کرکوف) ٬ کرایف - مربی: رینوس میشل#
#داور: جان تیلوراز انگلستان#
#تماشاگران: ۷۵,۲۰۰ نفر#
