#مرحله حذفی#

#یک‌چهارم پایانی#
#France#4#0#Northern Ireland#
#Sweden#2#0#Soviet Union#
#Brazil#1#0#Wales#
#West Germany#1#0#Yugoslavia#

#نیمه‌پایانی#
#Brazil#5#2#France#
#Sweden#3#1#West Germany#

#رده‌بندی#
#France#6#3#West Germany#

#پایانی#
#استکهلم - ۲۹ ژوئیه ۱۹۵۸#
#Brazil#5#2#Sweden#
#بازیکنان برزیل: گیلمار؛ جالما سانتوس، نیلتون سانتوس؛ اورلاندو، بلینی (کاپیتان)، زیتو؛ دیدی، گارینشا، واوا، پله، زاگالو#
#بازیکنان سوئد: اسونسون؛ برگمارک، آکسبوم؛ بوئریرسون، گوستاوسون، پارلیاگ؛ هامرین، گرن، سیمونسون، لیدهولم (کاپیتان)، اسکوگلوند#
#گل: ۲ واوا، ۲ پله، زاگالو (برزیل) – لیدهولم، سیمونسون (سوئد)#
#داور: گویگو (فرانسه)#
#تماشاگر: ۵۵۰۰۰ نفر#