#مرحله حذفی#

#یک‌هشتم پایانی – یک‌حذفی#
#Brazil#(3)1#1(2)#Chile#
#Colombia#2#0#Uruguay#
#Netherlands#2#1#Mexico#
#Costa Rica#1(5)#(3)1#Greece#
#France#2#0#Nigeria#
#Germany#2#1#Algeria#
#Argentina#1#0#Switzerland#
#Belgium#2#1#United States#

#یک‌چهارم پایانی#
#France#0#1#Germany#
#Brazil#2#1#Colombia#
#Argentina#1#0#Belgium#
#Netherlands#0(4)#(3)0#Costa Rica#

#نیمه‌پایانی#
#Brazil#1#7#Germany#
#Netherlands#0(2)#(4)0#Argentina#

#رده‌بندی#
#Brazil#0#3#Netherlands#

#پایانی#
# ۲۲ تیر ۱۳۹۳ - ورزشگاه ماراکانا, ریودو ژانیرو #
#Germany#1#0#Argentina#
#گل ها : ماریو گوتزه ( '۱۱۳) #
#بازیکنان آلمان :  مانوئل نویر، متس هوملس، جروم بواتنگ، هوودس، فیلیپ لام (کاپیتان)، کریستوف کرامر (از دقیقه 31 آندره شورله)، شواین اشتاینگر، تونی کروس، مسعوت اوزیل(از دقیقه 118 مرتاساکر)، توماس مولر و میرسلاو کلوزه (از دقیقه 88 ماریو گوتزه) سرمربی : یوآخیم لوو #
#بازیکنان آرژانتین : رومرو، گارای، پابلو زابالتا، انزو پرز (از دقیقه 86 فرناندو گاگو)، گونزالو هیگواین (از دقیقه 77 رودریگو پالاسیو)، لیونل مسی (کاپیتان)، خاویر ماسکرانو، دیمیکلیس، روخو، بیگلیا و لاوتزی (از دقیقه 46 آگوئرو) سرمربي: آلخاندرو سابه یا #
#داور: نیکولا ریتزولی(ایتالیا)#
#تماشاگر: ۷۴۷۳۸ نفر#