#مرحله حذفی#
#نیمه‌پایانی#
#Argentina#6#1#United States#
#Uruguay#6#1#Yugoslavia#
#پایانی#
#مونته‌ویدئو - ۳۰ جولای ۱۹۳۰#
#Uruguay#4#2#Argentina#
#بازیکنان اروگوئه: بالسترو؛ ناسازی (کاپیتان)، ماسچرونی؛ آندراده، فرناندز، خستیدو؛ دورادو، اسکارونه، کاسترو، چه‌آ، ایریارته#
#بازیکنان آرژانتین: بوتاسو؛ دلا توره، پاترنوستر؛ ج اواریستو، مونتی، سوارز؛ پئوسله، وارالو، استابیله، فریرا (کاپیتان)، م اواریستو#
#گل: دورادو، چه‌آ، ایریارته، کاسترو (اروگوئه) – پئوسله، استابیله (آرژانتین)#
#داور: لانژنوس (بلژیک)#
#تماشاگر: ۹۰۰۰۰ نفر#

