#مرحله حذفی#

#یک‌چهارم پایانی#
#Uruguay#4#2#England#
#Hungary#4#2#Brazil#
#Austria#7#5#Switzerland#
#West Germany#2#0#Yugoslavia#

#نیمه‌پایانی#
#Hungary#4#2#Uruguay#
#West Germany#6#1#Austria#

#رده‌بندی#
#Austria#3#1#Uruguay#

#پایانی#
#برن - ۴ ژوئیه ۱۹۵۴#
#West Germany#3#2#Hungary#
#بازیکنان آلمان غربی: تورک؛ پوسیپال، کول‌مه‌یر؛ اکل، لیبریخ، مای؛ ران، مورلوک، ا والتر، ف والتر (کاپیتان)، شافر#
#بازیکنان مجارستان: گروسیش؛ بوزانسکی، لانتوس؛ بوژیک، لورانت، زاکاریاس؛ ژیبور، ساندرا کوشیس، هیده‌کوتی، فرانس پوشکاش (کاپیتان)، ج توت#
#گل: دقیقه ۴ پوشکاش، دقیقه ۹ ژیبور - مجارستان ، دقیقه ۱۰ مورلوک، دقیقه ۱۸ و ۸۴ ران - آلمان غربی #
#داور: لینگ (انگلستان)#
#تماشاگر: ۵۰۰۰۰ نفر#
